Johann Conrad Frank | Anne Catharine Dorothee Friederika Merten
Adam Jacob Strauch | Johanne Friederike Wimmer
Johann Matthaeus Gottlob Frank | Anne Barbare Cramer
Johann Heinrich Arnold | Christiane Friederike Elisabeth Kieser
Johann Ernst Schreiber | Anne Christin Liemen
----------------
Johann Jacob Christoph Trescher | Christiane Neuße
Matthaeus Benjamin Liemen | Catharine Magdalene Sophie Liemen
----------------
Justinus Heinrich Liemen | Barbare Rosine Louise Seyfarth
Jacob Christian Liemen | Anne Margarethe Roth
Friedrich Wilhelm Fischer | Anne Marie Christine Stollberg
Johann Casper Simon Rudloff | Rosine Magdalene Trescher
----------------
Heinrich Daniel Wachsmann | Rosine Marie Caroline Seyfarth
Johann Jacob Marius Tappert | Johanne Ernestine Therese Seyfarth
Valentin Christian Trescher | Susanne Marie Sophie Trescher
----------------
Johann Valentin Wilhelm Trescher | Barbare Rosine Scheegaß
Johann Valentin Christoph Liemen | Luise Friederike Göbel
Johann Georg Brand | Marie Georgine Caroline Trescher
Jacob Christoph Liemen | Anna Elisabethe Möller
----------------
Carl Christoph Wilhelm Seyfarth | Rosine Marie Magdalene Trescher
Emil Schneider | Marie Margarethe Wagner
Jacob Matthaeus Bernhard Liemen | Anne Martha Görlach
----------------
Johann Michael Füldner | Marie Elisabeth Christine Liemen
Johann Valentin Simmen | Marthe Dorothee Charlotte Kieser
Johann Peter Christoph Brand | Wilhelmine Ernestine Kritzmann
Heinrich Oetterer | Catharine Margarethe Schönau
----------------
Georg Adam Schöner | Anne Catharine Loeffler
Carl August Witzmann | Eve Catharine Jung
----------------
Christoph Wilhelm Seyfarth | Sophie Luise Lämmerhirt
Heinrich Christoph Brand | Catharine Magdalene Ernestine Möller
Justus Heinrich Fischer | Barbare Elisabeth Christine Seyfarth
Johann August Cramer | Sophie Christiane Wachsmann
----------------
Johann Georg Rudloff | Catharine Margarethe Roth
Caspar Gotthilf Frank | Anne Christine Schottmann
Johann Georg Frank | Marthe Catharine Walter
Friedrich Andreas Liemen | Barbare Marie Sophie Rudloff
----------------
Wilhelm Matthaeus Brand | Marthe Clare Reif
Johann Matthaeus Bindemann | Anne Christine Tappert
----------------
Heinrich Gottlob Tappert | Rosine Marie Kieser
Valentin Christoph Liemen | Maria Sophie Henriette Möller
Johannes Hofmann | Christiane Friederike Moeller
----------------
Heinrich Gottlob Heßenstein | Eve Christiane Wachsmann
Gottfried Wilhelm Sturm | Anna Magdalena Schieck
Christoph Stecher | Caroline Wilhelmine Rothe
Johann Matthaeus Liemen | Martha Elisabetha Reinhardt
----------------
Friedrich Andreas Seyfarth | Johanne Christiane Reinhardt
Christian Friedrich Türk | Johanne Christiane Caroline Brack
Justinus Heinrich Liemen | Rosina Maria Wilhelmina Seyfarth
Christian Wilhelm Liemen | Eva Christina Liemen
Johann Andreas Graetzler | Marie Christine Schoenau
----------------
Friedrich Christoph Eduard Kranch | Barbara Louise Rosine Trescher
Johann Jacob Oschmann | Barbara Elisabetha Schellhaß
Johann Ludwig Schmeißer | Christina Elisabetha Sophia Schoenau
Georg Ernst Liemen | Anna Christina Liemen
Johann Heinrich Krieg | Catharine Elisabethe Neuland
----------------
Georg Christian Wachsmann | Barbara Margarethe Saul
Johann Valentin Jacob Kranich | Anna Martha Fischer
Johann Georg Baumbach | Anna Christina Carolina Wachsmann
----------------
Friedrich Matthaeus Seyfahrt | Rosine Marie Sophie Liemen
----------------
Friedrich Andreas Seifarth | Lisette Christiane Dürrfeld
Johann Valentin Platz | Rosine Margarethe Köhler
Georg Adam Schoenau | Anna Elisabetha Catterfeld
Justinus Heinrich Liemen | Hanna Christina Seyfarth
----------------
Johann Friedrich August Köhler | Sophia Carolina Merbach
Christian Heinrich Friedrich Drescher | Rosine Marie Dorothee Wachsmann
----------------
Johann Valentin Lux | Rosine Marie Sophie Koehler
Georg Friedrich Roth | Johann Rosine Kött
Johann Christoph Fischer | Anne Margarethe Semm
----------------
Heinrich Julius Wendelmuth | Marie Theresie Schneidewind
Johann Heinrich Ferdinand Seyfarth | Rosine Marie Henriette Brückmann
August Heinrich Liemen | Eva Rosina Marie Wettstein
Heinrich Theodor Liemen | Anne Martha Rohschenkel
Friedrich Matthaeus Trescher | Barbara Rosina Louise Kranch
----------------
August Adelbert Lencer | August Thecla Graefenhahn
Gottfried Eduard Brand | Eve Catharine Rosalie Wilhelmine Beck
----------------
Gottfried Eduard Matthaeus Liemen | Henriette Friederike Schröter
Christian Wilhelm Frank | Auguste Elisabeth Schneider
August Wilhelm Seyfarth | Magdalena Friederike Drescher
Conrad Christian Lux | Catharine Elisabetha Hoßfeld
----------------
Johann Christoph Dorotheus Toedteberg | Barbara Rosine Ernestine Lux
Johann Heinrich Kallensee | Caroline Dorette Schütz
----------------
Friedrich August Wettstein | Susanna Margaretha Hoßfeld
Johann Michael Bärenklau | Maria Catharina Köhler
Georg Friedrich Cramer | Johanne Magdalena Kleysteuber
Johann Matthaeus Eccarius | Anna Margaretha Henriette Liemen
----------------
Johann Michael Theodor Lux | Marie Sophie Caroline Liemen
August Wilhelm Dorotheus Gebser | Therese Wilhelmine Seyfarth
----------------
Justinus Heinrich Merbach | Sophie Caroline Therese Schreiber
Johann Georg August Liemen | Catharine Magdalene Ernestine Brand
Valentin Christoph Trescher | Barbara Rosine Ernestine Haffenstein
Georg Friedrich Liemen | Marie Catharine Meyfarth
----------------
Valentin Heinrich Wachsmann | Anna Dorothea Boettner
Richard Stötzer | Auguste Louise Mathilde Schieck
----------------
Johann Friedrich Lux | Eve Dorothee Stehmann
Friedrich Martin August Daniel | Anne Catharine Trescher
Carl Friedrich Matthaeus Brückmann | Rosine Louise Dorette Justin
Johann Christoph Martin Schlegel | Anne Dorothee Friedericke Ratzmann
Wilhelm Christian Wachsmann | Caroline Sophie Margarethe Liemen
----------------
Johann Georg Ratzmann | Rosine Maria Frühauf
Heinrich Wilhelm Günther | Christina Elisabetha Sophia Schmeißer
Friedrich Christian Liemen | Lisette Christiane Seyfarth
----------------
Johann Georg Kehr | Rosine Louise Strauch
Carl Friedrich Matthaeus Liemen | Eve Christine Louise Seyfahrt
Otto Friedrich Seyfarth | Pauline Henriette Seyfahrt
Heinrich Daniel Liemen | Louise Caroline Schellhaß
----------------
Carl Christoph Gottlieb Liemen | Caroline Friedericke Rudloff
Georg Ernst Friedrich | Eve Christiane Henriette Strauch
----------------
David Schack | Elisabetha Christina Eleonora Liemen
Johann Georg Möller | Johanne Georgine Wilhelmine Louise Töteberg
August Heinrich Liemen | Louise Wilhelmine Krieg
Matthaeus Gottlob Kallensee | Eva Rosine Roth
----------------
Friedrich Christoph Brand | Eve Christine Wilhelmine Liemen
----------------
Christoph Wilhelm Trescher | Rosine Luise Dorette Liemen
Johann Matthaeus Benjamin Köhler | Lina Auguste Sachse
----------------
Johann Heinrich Groß | Barbara Margarethe Henriette Lux
Justinus Heinrich Merbach | Magdalene Margarethe Beng
----------------
Valentin Heinrich Krnach | Rosine Georgine Caroline Brand
Johann Andreas Wagner | Dorothee Caroline Frank
----------------
Carl Gottlob Seifahrt | Marie Luise Dorette Rudloff
Johann Andreas Schmidt | Eve Dorothee Lux
Franciscus Friedrich Martin Kühn | Luise Marie Therese Arnold
----------------
Friedrich Wilhelm Göring | Marie Sophie Liemen
Valentin Jacob Brand | Dorothee Marie Oertmann
Johann Heinrich Liebetrau | Christiane Wilhelmine Lux
----------------
Johann Valentin Meyfarth | Eva Catharine Magdalena Trescher
Jacob Heinrich Liebetrau | Auguste Rosine Henriette Lux
Carl Benjamin Liemen | Anna Elisabeth Bechthum
August Theodor Seyfarth | Anne Christine Therese Wachsmann
----------------
Johann Ernst Weyda | Christine Wilhelmine Trescher
Andreas Bernhard Göpel | Lina Auguste Köhler
Carl Wilhelm Wachsmann | Johanne Wilhelmine Rosalie Baumbach
----------------
Friedrich David Emil Herrmann | Rosine Marie Sophie Frank
Valentin Emil Wachsmann | Amalie Regine Wilhelmine Bindemann
Georg Ernst Otto Liemen | Sophie Wilhelmine Wachsmann
----------------
Friedrich Theodor Seyfarth | Wilhelmine Christiane Fischer
----------------
Georg August Bindemann | Therese Adolphine Christiane Graefenhahn
Gottlob Christian Louis Kallensee | Johanne Marie Therese Köhler
----------------
Johann August Ehrhardt | Barbara Rosine Ernestine Trescher
Jacob Marius Eduard Brand | Margarethe Wilhelmine Fischer
Carl Matthaeus Bindemann | Rosine Marie Louise Brand
Valentin Wilhelm Seyfarth | Martha Therese Brand
----------------
Johann August Allmrodt | Louise Wilhelmine Therese Bindemann
Carl August Heinrich Haßenstein | Ernestine Therese Liemen
Jacob Heinrich Ferdinand Tappert | Amalie Henriette Kühr
----------------
Friedrich Wilhelm Arnold | Louise Riede
Wilhelm Baumbach | Christiane Henriette Seifarth
Carl Christian Starkloff | Marie Dorothea Frank
Johann Georg Rudloff | Katharine Christine Stiefel
----------------
August Louis Ortlepp | Eva Therese Wilhelmine Kött
Friedrich Andreas Schreiber | Marie Christiane Liemen
Heinrich Ferdinand Wachsmann | Martha Rosine Zink
Carl Heinrich Kranch | Ernestine Therese Caroline Haßenstein
Karl Friedrich Woellner | Ernestine Therese Frank
----------------
Carl Christoph Trescher | Lisette Ernestine Rosalie Göring
August Heinrich Frank | Ernestine Therese Karoline Thörmer
----------------
Ernst Friedrich Julius Riede | Regine Sophie Caroline Trescher
August Heinrich Liemen | Emilie Therese Wachsmann
Heinrich Eduard Tappert | Caroline Marie Bertha Paul
Friedrich August Tappert | Marie Sophie Stoll
