Adolf Reifschneider | Auguste Caroline Charlotte Schuster
Johann Georg Ernst Conrad Fischer | Johanne Friedericke Kühnas
Johann Heinrich Dille | Auguste Alt
Johann Heinrich Friedrich Theodor Sterzing | Caroline Wilhelmine Hildebrandt
Wilhelm Christian Friedrich Eschner | Rosalie Auguste Weiß
----------------
Christian Heinrich Hafermann | Johanne Friedericke Caroline Beckschwardt
Friedrich Hilmar Oscar Christian Otto Kleißer | Johanne Friedericke Ernestine Popp
Carl Bernhard Albert Wilhelm Spindtler | Agnes Marie Caroline Hafer
Wilhelm Bernhard Frommann | Auguste Wilhelmine Rosalie Stichling
Christian Heinrich Friedrich August Hermann Umbreit | Marianne Henriette Friedericke Wolf
----------------
Andreas Theodor Eduard Kummer | Johanne Friedericke Seeber
Carl Christoph Joseph Reuß | Johanne Friedericke Wilhelmine Ernestine Seßler
Theodor Friedrich Möhring | Friedericke Dorothea Ernestine Elisabeth Reich
Heinrich Christian Daniel Theodor Frenzel | Ernestine Henriette Amling
Ernst Friedrich Heinrich Heuke | Anna Dorothea Louise Hofmann
----------------
Heinrich Theodor Ferdinand Ose | Johanne Christiane Dorothea Friedericke Umbreit
August Christian Mälzer | Pauline Minna Ortlepp
Carl August Herda | Caroline Friedericke Graf
Heinrich Wilhelm Kümmerling | Johanne Georgine Wilhelmine Dorothea Schenk
Johann Carl Eduard Bochröder | Johanne Marie Therese Seyfarth
Carl Eduard Cramer | Friedericke Eleonore Louise Frenzel
----------------
Georg Wilhelm Christian Heinrich Anschütz | Johanne Marie Friedericke Georgine Schilk
Johann Christoph Christian Stärk | Henriette Wilhelmine Potz
Bernhard Christian Eduard Carl | Caroline Friedericke Louise Görlach
Johann Christian Theodor Reinhardt | Clara Elise Mehlis
Emil Triebel | Marie Christiane Cramer
Johann Friedrich Bartholomäus Möller | Johanne Friedericke Anschütz
----------------
Ernst Theodor August Bezold | Friedericke Christiane Elisabeth Grebhahn
Georg Friedrich Albrecht | Auguste Ottilie Jacobs
Johann Jacob August Meßing | Johanne Wilhelmine Friedericke Wendterodt
Johann Philipp Christian Aschenbach | Louise Henriette Köllmer
Wilhelm Louis Thielemann | Caroline Sophie Schumann
Wilhelm Friedrich Louis Fischer | Marie Louise Ernestine Willing
----------------
Eduard Alexander Hermann Stengel | Friedericke Sophie Louise Barth
Carl Friedrich Möller | Ernestine Dorothea Christiane Friedericke Schenk
Johannes Friedrich Mangold | Anna Martha Marx
Georg Friedrich Julius Zierdt | Louise Henriette Friedericke Ludwig
Johann Matthäus Friedrich Schmücking | Johanne Ernestine Therese Ehrhardt
----------------
Heinrich Emanule Roth | Marie Friedericke Margarethe Henriette Böhler
Julius Leihbecher | Amalie Eßigr
Carl Friedrich Louis Leffler | Henriette Friedericke Christiane Pfau
Johann Christian Friedrich Bernhard Mühle | Johanne Luise Friedericke Franziska Wolf
Christian Wilhelm Ihling | Anna Christine Metz
Johann Christian Andreas Hofmann | Johanne Marie Elisabeth Henriette Potz
----------------
Friedrich Andreas Metz | Rosalie Friedericke Fischer
Ernst Christian August Geyer | Ida Auguste Dorette Rasch
Johann Georg Eduard Eckoldt | Johanne Friedericke Seyfarth
Emil August Leonhard Gottfried John | Johanne Georgine Friedericke Wilhelmine Anschütz
Otto Friedrich Bruni Heynhold | Lina Potz
Carl Eduard Cramer | Johanne Christiane Friedericke Wilhelmine Schmidt
----------------
Georg Friedrich Wilhelm Hartung | Friedericke Caroline Louise Andrä
Christian Emil Bernhard Groß | Johanne Friedericke Rosalie Louise Faulstich
Wilhelm Richard Barthels | Bertha Caroline Seeber
Johann Friedrich Ullrich | Friedericke Wilhelmine Theodore Christiane Fischer
Johann Heinrich Gottlieb Carl Pfaff | Georgine Dorothee Wilhelmine Friedericke Amling
Johann Ernst Friedrich Heyder | Johanne Christiane Friedericke Drothee Schmidt
----------------
Friedrich Ernst August Lapp | Marie Therese Heß
Friedrich Ernst Heinrich Wilhelm Mahr | Friedericke Wilhelmine Ernestine Auguste Hafermann
Georg Carl August Hofmann | Emilie Wilhelmine Emma Graf
Johann Conrad Michael August Umbreit | Johanne Elisabeth Philippine Kraußer
Heinrich Louis Rohr | Christiane Therese Fetzer
Carl August Debes | Adele Trognitz
----------------
Wilhelm Friedrich Louis Lapp | Louise Wilhelmine Henriette Auguste Knorr
Johann Georg Eisenacher | Johanne Friedericke Henriette Fischer
Friedrich August Theodor Hofmann | Caroline Lisette Reiß
Otto Richard Hertwig | Henriette Malwine Stärk
Christian Friedrich Aschenbach | Johanne Marie Friedericke Kalbitz
Emil Christian August Friedrich Strobel | Leopoldine Marr
----------------
Ernst Bernhard Philipp Kirchner | Anna Therese Herrmann
Robert Krumbholz | Johanne Friedericke Wilhelmine Hopf
Johann Georg Carl Christian Grobert | Johanne Elisabethe Gehrhardt
Eduard Schoen | Auguste Dorette Vierschrodt
August Lapp | Friedericke Wilhelmine Henriette Anschütz
Johann Christian Carl Emil Merten | Christiane Wilhelmine Henriette Friedericke Ullrich
----------------
Carl Friedrich Heinrich August Kreuch | Johanne Christiane Wilhelmine Magdalene Nocke
Carl Wilhelm Louis Emil Hildebrandt | Emma Rosalie Bonsack
Carl Louis Habicht | Anna Charlotte Rosalie Wilhelmine Popp
Johann Heinrich Christian Beck | Dorothee Sophie Caroline Ernestine Reichardt
Albert Otto Bachröder | Christiane Friedericke Topf
----------------
Ernst Christian Carl Theodor Seeber | Johanne Christiane Friedericke Elisabethe Lux
Johann Heinrich Christian Weide | Johanne Catharine Schmidt
Franz Eduard Thomas | Caroline Charlotte Cramer
Johann Friedrich Wilhelm Theodor Willing | Johanne Friedericke Rödlicher
Johann Wilhelm Uschmann | Friedericke Christiane Auguste Wilhelmine Bochröder
Christian Friedrich Sebastian Kalbitz | Elise Caroline Bach
----------------
Johann Friedrich Martin Anschütz | Constantine Marie Friedericke Elisabethe Heß
Friedrich Wilhelm Barth | Louise Henriette Kleiser
Johann Friedrich Ludwig Hofmann | Lisette Wilhelmine Dickhoff
Julius Adolph Zentgraf | Henriette Dorothee Louise Willing
August Louis Christian Leopold | Georgine Friedericke Wilhelmine Louise Willing
Gustav Günther Otto | Anna Maria Greulich
----------------
Johann Friedrich Louis Pfaff | Johanne Dorothee Friedericke Henriette Ortlepp
Christian Friedrich August Braun | Henriette Elisabethe Heinz
Johann Georg Christoph Wilhelm Willing | Johanne Marie Magdalene Urban
Ernst August Edmund Muth | Johanne Georgine Meister
Georg Reinhold Scharf | Caroline Rosalie Triebel
----------------
Jacob Ernst Römhildt | Ottilie Christiane Nocke
Johann Ludwig Ferdinand Schuhmann | Christiane Marie Louise Wilhelmine Weisheit
Wilhelm August Zentgraf | Johanne Ernestine Friedericke Christiane Umbreit
Carl Friedrich Christian Heinrich Wilhelm Lösch | Wilhelmine Friedericke Caroline Theylich
Friedrich Christian Wilhelm Keil | Auguste Louise Beutecamp
----------------
Gustav Christoph Ludwig Reinhold | Olga Friedericke Ottilie Thusnelde Hafer
----------------
Carl August Christian Richard Hahn | Christiane Dorothee Henriette Friedericke Kämmerer
Carl Constantin Peter | Auguste Henriette Christiane Schumann
Georg Andreas Volkmar Ortlepp | Johanne Charlotte Merbach
Gottlieb Köllmer | Johanne Marie Horn
Friedrich August Werner | Wilhelmine Friedericke Hofmann
Wilhelm Heinrich Kuhles | Emilie Lisette Fanny Peter
----------------
Johann Georg Christian Friedrich Muth | Barbara Elisabethe Riede
Georg Ferdinand Keitel | Johanne Marie Weisheit
Johann Ernst Samuel Schmidt | Friedericke Dorothee Christiane Levine Kallbitz
Christian Friedrich Schuster | Alma Alwine Wilke
Ernst Bernhard Büchel | Johanne Friedericke Wilhelmine Dorothee Stärck
Ernst Traugott Fröhlich | Johanne Christiane Henriette Caroline Hartmann
----------------
Carl Friedrich Triebel | Marie Dorothee Seeber
Johann Friedrich Pfau | Johanne Auguste Georgine Caroline Beck
Christian Theodor Pabst | Georgine Friedericke Ernestine Christiane Koellmer
Georg Christian Meßing | Christiane Margarethe Willing
Friedrich Louis Hartmann | Wilhelmine Christiane Friedericke Elisabeth Popp
Wilhelm August Ludwig Vollmer | Georgine Christiane Wilhelmine Keitel
----------------
Friedrich Louis Drößler | Johanne Marie Elisabethe Siedelbach
Johann Andreas Heinrich Ritter | Caroline Rosalie Eck
Georg Michael Gottfried Oscar John | Friedericke Rosalie Köllner
----------------
Carl Hugo Braun | Hedwig Rosamunde Thienemann
Christian Eduard Ullrich | Ernestine Wilhelmine Dorothee Henriette Willing
Carl Eduard Linse | Caroline Friedericke Kallenberg
Johann Ludwig Hermann Knauß | Caroline Friedericke Dorothee Cramer
Georg Friedrich Köllmer | Ernestine Kalb
----------------
Johann Theodor Ernst Heinrich Hölbe | Johanne Georgine Wilhelmine Göpfert
Johann Heinrich Starkloff | Johanne Sophie Auguste Kirtzmann
Johann Heinrich Theodor Wenig | Johanne Caroline Sänger
Johann Heinrich Christian Theodor Möller | Dorothee Wilhelmine Auguste Heußer
Johann Carl Wilhelm Hartmann | Georgine Ernestine Dorothee Wolf
Christian Theodor Langenhan | Friedericke Georgine Henriette Lauterbach
----------------
Johann Heinrich Wilhelm Bernhard Emil Blechschmidt | Ernestine Caroline Platz
Friedrich Emil Christian Theodor Hölbe | Henriette Magdalene Louise Mosch
Christian Julius Triebel | Georgine Friedericke Strobel
Heinrich Theodor Friedrich Eßiger | Johanne Rosalie Drößler
Alwin Robert Fechner | Dorothee Henriette Magdalene Rosalie Sterzing
----------------
Gottfried Gustav Keller | Meta Weidner
Johann Michael Groß | Johanne Friedericke Henriette Braun
Friedrich Christian Alexander Hofmann | Dorothee Friedericke Kummer
Johann Heinrich Christian Joseph Meister | Christiane Friedericke Triebel
Friedrich August Weißensee | Bertha Rosalie Eisentraut
Friedrich Wilhelm Keil | Johanne Henriette Helene Auguste Keil
----------------
Johann Joseph Friedrich Mosch | Louise Wilhelmine Lauterbach
Caspar Friedrich Marr | Ernestine Wilhelmine Albertine Amling
August Christian Friedrich Wilhelm Eßiger | Marie Christiane Friedericke Cramer
Ernst Friedrich Carl Ehrhardt | Georgine Christian Pauline Noßmann
Johann Ernst Friedrich Weidner | Johanne Friedericke Möller
Carl Friedrich Louise Wilhelm Amling | Anne Wilhelmine Seßler
----------------
Heinrich Theodor Naupert | Johanne Caroline Fetzer
Carl Friedrich Günther | Johanne Christiane Dorothee Wilhelmine Beck
Friedrich Wilhelm Kärst | Christiane Friedericke Henriette Marie Reuß
Wilhelm August Hartung | Margarethe Schwarz
Friedrich Richard Wenig | Auguste Henriette Christiane Frenzel
Friedrich Ernst Theodor May | Wilhelmine Charlotte Therese Tanz
----------------
Johann Georg Koellmer | Johanne Friedericke Henriette Seßler
Carl Heinrich Friedrich Christian von der Eldern | Georgine Philippine Elise Anna Bischoff
Carl Horn | Marie Christiane Louise Cramer
Georg Friedrich Wilhelm Frenzel | Johanne Ullrich
Heinrich Friedrich Christian Beck| Friedericke Therese Sahlener
----------------
Carl Konrad Neuland | Johanne Franziska Auguste Christiane Ehrhardt
Heinrich Friedrich Theodor Willing | Anna Christiane Auguste Gundermann
August Christian Emil Hildebrandt | Amalie Charotte Henriette Hochmuth
Wilhelm Neuland | Auguste Christiane Hollstein
Ferdinand Carl Quendt | Emma Emilie Ida Auguste Beyer
----------------
Marinus Liedel | Caroline Friedericke Henriette Helma Stroh
Christian Franz Emil Friedrich Möller | Johanne Christiane Hildebrandt
Wilhelm Eduard Triebel | Melitta Margarethe Wilhelmine Faulstich
Peter Höfels | Johanne Ernestine Wilhelmine Kreuch
Carl Friedrich König | Marie Ida Eisfelder
Carl Eduard Sörgel | Pauline Jenny Amande Lux
----------------
Hermann Emil Wolf | Johane Christiane Marie Siedelbach
Franz Pfannstiel | Lina Rosalie Scheermeßer
Johann Georg Friedrich Ernst Rudolph | Bertha Walther
Johann Wilhelm Friedrich Ludwig Carl | Johanne Friedericke Hofmann
Heinrich Kalbfuß | Emilie Antonie Ortlepp
August Ernst Wilhelm Platz | Magdalene Christiane Zeidler
----------------
Carl Friedrich Ernst Meßing | Rosalie Auguste Eschner
Louis Christian Wilhelm Theodor Willing | Wilhelmine Friedericke Henriette Magdalene Bochröder
Albert Albin Theodor Rechtenbach | Emma Emilie Ernestine Eßiger
Anton Gustav Eckardt | Dorothee Henriette Wenig
Friedrich Wilhelm Theodor Wiegand | Caroline Christiane Wilhelmine Hildebrandt
Georg Friedrich Alt | Tosca Mäder
----------------
Carl Wilhelm Hugo Winzer | Hedwig Kunigunde Straube
Johann Joseph Friedrich Mosch | Marie Christiane Strecker
Christian Bernhard Seyfried | Ernestine Christiane Willing
Christian Heinrich Friedrich Adolph Weymar | Louise Stötzer
Christian Heinrich Eduard Schmidt | Auguste Friedericke Christiane Georgine Sterzing
----------------
Carl Leopold Pfeiffer | Johanne Louise Meißner
Xaver Schütz | Sophie Caroline Emma Ernestine Gutmann
Carl Friedrich Emil Gottschall | Emma Eschner
Heinrich August Neubauer | Wilhelmine Ullrich
Constantin Heß | Friedericke Christiane Ernestine Popp
Carl Friedrich Ernst Herrmann | Emilie Köllmer
----------------
Friedrich Christian Louis August Pfau | Johanne Friedericke Christiane Auguste John
Christoph Heinrich Adalbert Eduard Hofmann | Auguste Ernestine Rosalie Wilhelmine Drößler
Johann Friedrich Pfau | Christiane Mosch
Friedrich August Wilhelm Wittmann | Auguste Friedericke Louise Ernestine Lösch
Benjamin Leberecht Traugott Herbst | Minna Ida Wirtz
Carl Heinrich Ernst August Kallenberg | Wilhelmine Georgine Johanne Ernestine Anschütz
----------------
Friedrich Wilhelm Robert Madlung | Friedericke Ernestine Wilhelmine Bochröder
Carl Joseph Dzur | Anna König
Johann Georg Heinrich Christian Wolf | Eduardine Marie Henriette Rosine Wartmann
Friedrich August Barlt | Marie Dorothee Bartholomäus
Wilhelm Christoph Pabst | Henriette Wilhelmine Stärk
Heinrich August Eduard Ungewitter | Charlotte Louise Ludwig
----------------
Ernst Heinrich Traugott Groß | Georgine Caroline Wilhelmine Carl
Johann Friedrich Heller | Marie Emilie Barbara Ellinger
Wilhelm Burkhardt | Sophie Auguste Kathinka Liedel
Theodor Heinrich Christian Carl Ortlepp | Marie Louise Mentzer
Christian Louis Creutzburg | Dorothee Friedericke Wilhelmine Amling
Heinrich Alexander Hey | Christiane Amande Julie Bochröder
----------------
Heinrich Christian Gottfried Starkloff | Emilie Caroline Hellbach
Friedrich Philipp Heinrich  Helder | Auguste Louise Wilhelmine Pauline Wolf
Christian Friedrich Max Theodor Weidner | Lisette Werner
Amor August Andreas Alwin Hertel | Marie Adelheid Eisfelder
Johann Friedrich Hoffmann | Christiane Ernestine Friedericke Wilhelmine Seeber
Christian August Theodor Möller | Ottilie Bertha Hulda Pabst
----------------
Carl Hanauer | Elly Hedwig Sophie Anna Dörtinger
Christian Friedrich Richard Ortlepp | Johanne Friedericke Ernestine Frommann
Johann Jeremias Hollstein | Ernestine Friedericke Gebhardt
Heinrich Wilhelm Friedrich Christian Frenzel | Johanne Auguste Tüttlepp
Ernst Gottfried Wilhelm Carl John | Johanne Dorothee Auguste Caroline Urban
Georg Eduard Carl Ernst Seeber | Johanne Magdalene Peter
----------------
Georg Wilhelm Heinrich Louis Wenig | Friedericke Christiane Wilhelmine Schner
----------------
Friedrich August Deckmann | Christiane Dorothee Wilhelmine Köllner
August Theodor Hafermann | Johanne Ernestine Louise Caroline Frenzel
Friedrich Eduard Otto Rudolph | Henriette Ullrich
Ernst Friedrich Christian August Meister | Marie Anna Böhler
Carl Gottfried Marx | Johanne Catharine Weide
Bernhard Wilhelm Gotthard Hertel | Johanne Marie Friedericke Schroder
----------------
Johann Richard Beyer | Ernestine Caroline Auguste Stärck
Christian Friedrich August Keil | Johanne Georgine Kallenberg
Gustav Christoph Ludwig Reinhold | Friedericke Louis Henriette Amling
Johann Friedrich Göpfert | Therese Auguste Heer
Eduard Koch | Louise Pauline Agnes Kurzius
Carl Friedrich August Catterfeld | Bertha Schumann
----------------
Johann Ernst Theodor Wilhelm Jahn | Christiane Seeber
Christian Julius Jäger | Louise Henriette Minna Marie Nocke
Johann Georg Friedrich Heinrich Frank | Friedericke Caroline Emilie Heißner
Friedrich Wilhelm Wackernagel | Johanne Dorothee Elise Rottstedt
Rudolph Cramer | Rosalie Henriette Louise Irene Muth
Georg Friedrich Philip Alt | Friedericke Wilhelmine Louise Kotl
----------------
Johann Georg Eccarius | Johanne Friedericke Auguste Ehrhardt
Ernst Julius Keil | Bertha Sophie Triebel
Friedrich Louis Kuhles | Auguste Albine Dietzel
Theodor Albert Ferdinand Max Fröbel | Ida Marie Henriette Auguste Seyfarth
Carl Eduard Pfeffer | Ernestine Christiane Ortlepp
Oscar Lorenz | Friedericke Christiane Louise Weidner
Otto Wilhelm Rönicke | Emilie Rödiger
----------------
Carl Friedrich Robert Panse | Marie Josine Seeber
Johann Friedrich Andreas Eschner | Johanne Christiane Friedericke Wilhelmine Cramer
Wilhelm Adolph Hieronymus Kleyßer | Elisabeth Auguste Lina Stolz
Carl Heinrich Moser | Clara Emilie Ortlepp
Christian Emil Leihbecher | Friedericke Amalie Heyer
Theodor Wilhelm Heinrich Christian Wenig | Wilhelmine Therese Christiane Auguste Willing
Johann Christian Heinrich Friedrich Kreuch | Johanne Louise Henriette Seeber
----------------
Friedrich August Kupfer | Friedericke Christiane Louise Noßmann
Caspar Leimbach | Johanne Wilhelmine Emilie Reinhold
Christian Ernst Louis Lapp | Johanne Friedericke Amalie Kämmerer
Johann Heinrich August Ludwig | Christiane Friedericke Herrmann
Johann Heinrich Gottfried Christian Knorr | Ernestine Friedericke Hopf
August Carl Christian Wilhelm John | Friedericke Christiane Wilhelmine Böhler
----------------
Reinhold Anton Saul | Lonny Georgine Idalie Rudloff