Ernst August Anschütz | Luise Adelheid Barthelmes
Friedrich Louis Heß | Luise Bertha von Nordheim
Christian Wilhelm Moeller | Luise Wolfine Hengelhaupt
Ernst August Bodenschatz | Auguste Debes
Jacob Kahl | Luise Bebet Büttner
Johannes Keiser | Luise Ernestine Ehrhard
Heinrich Louis Reich | Johanne Marie Amalie Wagner
Carl Heinrich Gustav Koenig | Johanne Elise Ernestine Koenig
----------------
Caspar Friedrich Ehrhard | Catharine Christiane Luise Wahl
Gottlieb Dallinger | Johanne Friederike Hulda Munsche
Gottfried Albin Wahl | Marie Caroline Wirsing
Friedrich Theodor Voigt | Christiane Hedwig Schneider
August Benjamin Moeller | August Christiane Doell
Ernst August Anschütz | Friederike Caroline Anschütz
Johann Martio Bischoff | Susanne Ernestine Wilhelmine Jung
----------------
Ernst Friedrich Hermann Doell | Friederike Therese Umbreit
Gottlieb August Wilhelm | Dorothea Emma Vent
Georg Ernst Barthelmes | Anna Kunigunde Hoefling
Conrad August Wagner | Luise Emilie Carl
Heinrich August Gierczynski | Lisette Emilie Fischer
Heinrich Beyer | Johanne Margarethe Moeller
Christian Wilhelm Louis Richard Spintler | Marie Henriette Auguste Spoerer
Johannes Conrad Ernst Wilhelm | Minna Martha Christiane Kunold
----------------
Georg Heinrich Christian Carl | Christiane Luise Hartleb
Peter Julius Fleischer | Johanne Elisabethe Blum
Johann Heinrich Carl | Susanne Bertha Goerking
----------------
Johann Simon Hermann Bernhard Derkes | Adelheid Heym
Friedrich Albert Kind | Christiane Rosalie Bodenschatz
Ernst Friedrich Hermann Haeusser | Mariane Lisette Hengelhaupt
Carl Friedrich Wilhelm Range | Mariane Amande Voigt
Johann Ernst Theodor Schülles | Johanne Christiane Ernestine Doell
Veit Theodor von Nordheim | Catharine Bertha Wagner
Franz Friedrich Valentin Emil Greiner | Sibylle Georgine Bertha Kürschner
----------------
Gustav Friedrich August Lapp | Marie Amalie Keßel
Hugo Gehrhardt | Hermine Ehrhardt
Franz Xaver Kaspar | Elwine Luise Spoerer
Friedrich Wilhelm Heß | Caroline Friederike Maeurer
Carl August Reuß | Sophie Christiane Wolf
Heinrich Ernst Reuß | Henriette Ernestine Pfaneschmidt
Louis Wilhelm Richard Fetzer | Johanne Margarethe Anschütz
----------------
Georg Carl Eduard Spoerer | Wilhelmine Ernestine Büchner
Gustav Adolph Zins | Maria Catharine Weiß
Franz Otto Brehm | Anna Hermine Schindler
Johann Ernst Werner | Nelly Amalie Barthelmes
Ernst Christian Hildpert | Henriette Friederike Caroline Heyl
Peter Heinrich Diemar | Johanne Friederike Luise Steigleder
Johannes Ludwig Reinhold Spoerer | Friederike Luise Georgine Adami
----------------
Gottfried Wilhelm Boehm  | Marie Emilie Amande Reich
Carl Moritz Uhl | Auguste Mathilde Agnes Hartmann
Johann Ernst Bader | Christiane Elise Popp
Valentin Ernst Beck | Christiane Rosalie Reinholdine Luca
Ernst August Emil Doell | Marie Ernestine Wahl
Johann Adam Herbst | Amalie Elise Lepper
Carl Reinhold von Nordheim | Thekla Alwine Barthelmes
----------------
Ernst August Bodenschatz | Antonie Caroline Georgine Schmidt
Georg Ernst Reuß | Dorothea Bernhardine Krauser
Heinrich Wilhelm Büchner | Elisabethe Ernestine Amberg
----------------
Friedrich Hermann Bohn | Georgine Caroline Koenig
Julius Adelbert Barthelmes | Auguste Henriette Schulze
Friedrich August Bader | Elise Emilie Ernestine Helfricht
Caspar Friedrich August Fuchs | Elise Wilhelmine Lapp
Fridolin Hugo Maeurer | Anna Christiane Anschütz
Carl Robert Alwin Seyfarth | Laura Thekla Hedwig Apel
Georg Valentin Geisenheimer | Luise Georgine Diemar
----------------
Heinrich August Gustav Koenig | Friederike Caroline Klein
Emil Richard Barthelmes | Marie Luise Therese Otto
Wilhelm Hugo Gustav Grahner | Auguste Henriette Schulze
Heinrich August Theodor Ehrhard | Augustine Winckler
Wilhelm Carl Emil Blum | Auguste Hedwig Korb
Robert Steinhausen | Friedericke Pauline Spörer
Valentin Robert Barthelmes | Caroline Christiane Friedericke Gottholdine Moritz
Georg Heinrich Schneider | Rosine Elise Weißleder
----------------
Julius Carl | Bernhardine Louise Büchner
----------------
Hermann Kühnes | Pauline Adelheid Amalie Müller
Carl Heinrich Wahl | Anna Elise Schneider
Ernst Scheerschmidt | Mathilde Merkel
Edmund Reinhard Barthelmes | Laurette Amalie Langebartel
Johann Christian August Berhinger | Marie Magdalene Rothämmel
Adolf Bernhard Goecking | Emilie Seifert
Johann Friedrich Oscar Stoetzer | Lisette Kommer
----------------
Johann Friedrich Schilling | Karoline Christiane Barthelmes
Gottlieb Dallinger | Emilie Auguste Jung
Gerhard August Hermann Schindler | Johanna Caroline Wagner
Conrad Hermann Müller | Minna Mathilde Barthelmes
Friedrich Wilhelm Werner | Marie Caroline Recknagel
Friedrich Wilhelm Trautmann | Amanda Heym
Oscar Hugo Barthelmes | Johanna Friedericke Luise Klett
----------------
Ernst Christian Amberg | Anna Elisabeth Kürschner
Friedrich Christian Klaubel | Christiane Friedericke Henriette Wagner
Christoph Heinrich Albert Büttner | Luise Barthelmes
Willibald Barthelmes | Leontine Fehringer
Peter Christian Albert Schneider | Ernestine Karoline Auguste Lapp
Heinrich Ernst Theodor Bartholomäus | Emilie Adelheid Schindler
Franz Traugott Wilhelm Theodor Apel | Elfriede Agnes Friedericke Wenige
----------------
Valentin Gustav Ernst Barthelmes | Elise Karoline Anschütz
Peter August Wilhelm | Marie Amalia Laura Anschütz
Alwin Kirchner | Auguste Friedericke Büchel
----------------
Eduard August Friedrich Ferdinand Welker | Pauline Auguste Bodenschatz
Christian Wahl | Minna Therese Helfricht
Eduard Ernst Schneider | Bertha Aurora Henriette Rudloff
Kaspar Georg Kühhirt | Elise Henriette Wahl
August Friedrich Schlegelmilch | Henriette Bertha Karl
Robert Oskar Mengler | Ernestine Gottlobine Schneider
Gustav Engelhard Barthelmes | Aminda Barthelmes
----------------
Christian Theodor Spörer | Marie Christiane Baringer
Heinrich Rudolf Barthelmes | Laura Sophie Bernhardine Will
Johann Gottlieb Friedrich Anton Voigt | Dorothea Friedericke Büchel
Friedrich Heinrich Amberg | Ernestine Agathe Will
Friedrich Wilhelm Moritz | Elise Karoline Marie Meurer
Karl Otto Werner | Auguste Christiane Wilhelmine Lapp
Ludwig Hermann Karl Helfricht | Christine Henning
----------------
Peter Christian Grosch | Gottholdine Rosalie Recknagel
Johann Heinrich König | Marie Christiane Spoerer
Gottfried Ludwig Schwarz | Marie Wilhelmine Amanda Langbein
Gustav Leopold Wunder | Johanna Henriette Antoniette Schindler
Karl Ferdinand Zöller | Karoline Emilie Morgenroth
Ernst Gottfried Decker | Friedericke Barbara Spörer
Georg Ernst Kraußer | Eva Rosine Hermann
----------------
Johann Christian Bolte | Lina Katharina Anschütz
Karl Emil Wilhelm | Christiane Sophie Katharina Scheermesser
----------------
Johann Gustav Christian Stoetzer | Anna Lina Hengelhaupt
Karl Christian Möller | Elise Friedericke Karoline Adlung
Albert Ernst Spörer | Ernestine Rosette Natalie Schwarz
Emil Friedrich Hermann Schneider | Friedericke Margarethe Diem
Christian Friedrich Bauerschmidt | Johanne Karoline Theolinde Recknagel
Johann Georg Vogel | Johanne Luise Holland
Heinrich Albert Holland | Auguste Mariane König
----------------
Christoph Friedrich Ernst Thiem | Emma Emilie Hulda Menz
Heinrich Jakob Brock | Dorothea Karoline Gramann
Heinrich Ernst Keiner | Auguste Magdalena Peter
Karl Friedrich Rommel | Elise Henne
Ernst Karl Oesring | Marie Ernesta Barthelmes
Heinrich August Bodenschatz | Johanna Wilhelmine Lorenz
Christian Edmund Göckings | Wilhelmine Bernhardine Döbner
----------------
Ernst Christian Karl Spoerer | Johanna Elisabeth Wilhelm
Gustav Emil Moritz | Luise Marie König
Friedericke Richard Volkmar | Luise Langenhau
Alwin Eduard Helfricht | Lisette Christiane Schneider
Bernhard Weiß | Auguste Wilhelmine Keiner
Valentin Christian Blum | Marie Margarethe Rothämel
----------------
Ernst Roedel | Laura Bernhardine Kathinka Langbein
Ernst Albert Klett | Emma Laurick
Ferdinand Louis Theodor Hengelhaupt | Emilie Spörer
Franz Karl Emil Selmar | Susanne Barbara Marx
Georg Bernhard Bader | Anna Marie Schard
Louis Domini Zöller | Amande Friedericke Barthelmes
----------------
Heinrich Theodor Hengelhaupt | Lisette Henriette König
Ernst Louis Rino Schneider | Susanne Katharine Rosalie Heldegart
Christian Reinhold Helfricht | Johanne Margarethe Ortlepp
Oswald Constantin Bruno Barthelmes | Rosalie Amanda Klett
Friedrich August Moritz | Dorothea Auguste Wild
Johannes Ehrhardt | Karoline Luck
Friedrich Wilhelm Gottlieb Döbler | Emilie Gottliebine Leipold
----------------
Heinrich August Emil Will | Marie Margarethe Bürckler
Heinrich Gottlieb Suchardt | Christiane Karoline Göckings
Friedrich Wilhelm Bittorf | Christiane Karoline Karl
Edmund Engelhardt Weihrauch | Elise Friedericke Wahl
Johann Adolf Schmeer | Mathilde Heyer
Adelbert Rino Barthelmes | Ernestine Karoline Bertha Moritz
Ferdinand Christian Barthelmes | Emma Elise Hoffmann
----------------
Karl Heinrich Jüttner | Friedericke Karoline Mathilde Schelle
Johannes Wahl | Sophie Christiane Diemar
Heinrich Albert Barthelmes | Elise Anschütz
Franz Hugo Spörer | Auguste Mariane Barthelmes
Heinrich Louis Klett | Henriette Minna Dietze
Friedrich August Hottenhof | Emma Keiner
Wilhelm Emil Kraußer | Luise Karoline Anschütz
----------------
Christian Albert Hengelhaupt | Ernestine Wilhelmine Ritz
Hermann Leopold Moritz | Christiane Marie Häusner
Hermann Schmidt | Emilie Moritz
Wolfgang Ernst Krainberger | Sophie Christine Wolf
Ernst Emil Wahl | Ernestine Christiane Nothnagel
Karl Gustav Kraußer | Agathe Franziska Luise Freitag
Ludwig Karl König | Auguste Friederike Christiane Flech
Karl Stier | Anna Helma Auguste Hemming
----------------
Adolf Ernst | Emma Friedericke Elise Oehring
Emil Hermann Hemleb | Luise Ernestine König
Hermann Friedrich Kirchner | Marie Barbara Büchel
Hermann Gottlieb Pfannschmidt | Rosalinde Luise Kraußer
Heinrich Karl Langenhau | Mathilde Amalie Schlütter
----------------
Oswald Moritz | Maria Libette Hengelhaupt
Wilhelm Zimmermann | Henriette Friedericke Ebert
Friedrich Hirth | Hermine Schnare
Johann Conrad Armknecht | Susanne Christiane Triebel
Louis Hugo Langenhau | Johanne Thekla Hartig
Hermann Oswald Hohlfeld | Elise Luck
Johann Karl Heinrich Schnetter | Karolie Antonie Klein
----------------
Bernhard Kind | Emilie Moritz
Johann Kaspar Arnold | Marie Margarethe Klett
Ernst August Bodenschatz | Bertha Katharina Gerbig
Christian Adam Berner | Johanna Dorothea Knauer
Emil Gottgetreu Müller | Friedericke Rothämel
Louis Hugo Barthelmes | Margarethe Georgine Mathilde Trapp
Heinrich Wilhelm Hermann Decker | Helma Agnes Eckstein
Christian August Schneider | Marianne Mäurer
----------------
Christian Nikolaus Kührt | Luise Ernestine Auguste Babette Greifzu
----------------
Wilhelm Theodor Storch | Christiane Henriette Amberg
Franz Xaver Kaspar | Ernestine Spörer
Wilhelm Blum | Wilhelmine Pauline Fehringer
Richard Helfricht | Adolfine Julich
Heinrich Theodor Karl | Luise Kaufmann
Franz Müller | Laura Büchner
Gottlob Christian Louis Oetterer | Hermine Helfricht
----------------
Johann Georg Weiß | Maria Friedericke Raumschüssel
Gottfried Melchior | Helene Maria Luise Bruchholz
Friedrich August Fischer | Marie Hulda Pauline Schiffner
Wilhelm Ferdinand August Stollberg | Karoline Rosalie Pistor
Heinrich Wilhelm Büchner | Marie Luise Behringer
Heinrich August Gottlieb Werner | Auguste Valerie Moritz
Heinrich Ernst Louis Ludwig | Lina Ernestine Kautz
----------------
Julius Wagner | Amanda Greiner
Ernst Christian Karl Gottlieb Demmler | Laurette Barthelmes
Heinrich Albert Ritz | Emilie Möller
Paul Friedrich Lotz | Emilie Thusnelda Bertha Oehring
Samuel Benjamin Anschütz | Marie Luise Kommer
August Christian Diemar | Bertha Blauroth
Georg August Hornschuch | Anna Friedericke Hoffmann
Georg Ernst Kraußer | Luise Marie Behringer
----------------
Johann Stephan Kupfer | Marie Ernestine Behringer
Christian Emil Wahl | Georgine Ernestine Jäger
Ernst Friedrich Krell | Amalie Oehring
Friedrich Theodor Göckings | Johanna Christiana Raßmann
Heinrich Emil Wahl | Christiane Döll
Gottlieb Emil Büttner | Laura Franziska Barthelmes
Julius Recknagel | Karoline Büttner
----------------
Christian Oswald Suchardt | Elise Christiana Mangler
Karl Peter Reinhold Weißheit | Johanna Emilie Möller
Christian Reinhold Bader | Maria Elisabeth König
Wilhelm Gottfried Barthelmes | Emma Christiane Otto
Richard Mäurer | Maria Henriette Auguste Rommel
Kaspar August Brand | Henriette Büchner
Louis Friedrich Julius August Kaufmann | Emilie Luise Ottilie Steuding
Karl Anton Alwin König | Marie Christiane Nothnagel
----------------
August Hengelhaupt | Marie Moritz
----------------
Friedrich Wilhelm Hauf | Leontine von Nordheim
Karl Bernhard König | Hermine Luise Moritz
Louis Friedrich Rudolf | Christiane Henriette Hengelhaupt
Ferdinand Heinrich Moritz | Emma Rosalie Anna Helfricht
Johann Kaspar Kirchner | Marie Elise Christiane Auguste Lapp
Karl Georg Lorenz | Amalie Meißner
Friedrich August Urban | Mathilde Schmeer
----------------
Karl Friedrich Klett | Minna Barthelmes
Bernhard Bader | Christiane Emma Liebaug
Christian Leopold Helfricht | Anna Dorothea Blum
Emil Sauger | Elise Häusner
Wilhelm Friedrich Benjamin Zeyß | Emma Jäger
Friedrich Hermann Kummer | Thekla Christiane Elise Natalie Anschütz
August Edmund Karl | Anna Ernestine Moritz
Gustav Bernhard Popp | Marie Christiane Burckhardt
----------------
Victor Hugo von Nordheim | Emilie Kaufmann
Ernst Karl Anschütz | Auguste Kraußer
Johann Georg Ußfeller | Christiane Emilie Reising
Gebhard Rudolf Spörer | Friedericka Karoline Adelheid Reinhardt
Julius Emil Will | Maria Elisabeth Julia Fischer
Edwin Albrecht Hugo Schlütter | Anna Wilhelmine Schattler
Valentin Wagner | Katharina Margarethe Kainer
Georg Karl Hengelhaupt | Henriette Hedwig Moritz
----------------
Ernst August Anschütz | Ernestine Friedericke Beta Langenhau
Friedrich Fuchs | Ernestine Wilhelmine Wagner
Julius Otto | Katharine Elisabeth Jobst
Johann Georg Andreas | Christiane Recknagel
Georg Ernst Theodor Reuß | Dorothea Lisette Weißleder
Wilhelm Göckings | Johanne Henriette Büchel
Christian Kleinert | Christine Karoline Bickel
Gottfried Adolf Hilsebein | Marie Bouise von Nordheim
----------------
Louis Christian Helfricht | Laura Luise Korb
Ernst Roth | Ida Recknagel
Heinrich Ludwig Eduard Adlung | Sabine Friedericke Fischer
Johannes Emil Kummer | Rosalie Möller
Mattheus Karl Nothnagel | Laura Elwine Adlung
Karl Friedrich Christian Bergmann | Ernestine Pauline Reuß
Franz Bernhard Alwin Spoerer | Luise Bertha Weiß
----------------
Ernst Theodor Dreyße | Emma Luise Henriette Wilhelmine Apel
Friedrich Traugott Louis Schiller | Lina Emma Hemming
Karl Hermann Klett | Friedericka Auguste Hengelhaupt
Andreas Knoll | Christiane Luise Büchel
Heinrich Christian Karl Wahl | Emilie Schneider
Heinrich Ludwig Schneider | Luise Emilie Suchardt
Johannes Gottlieb Robert von Nordheim | Luise Ernestine Georgine Pfannschmidt
----------------
August Wilhelm Blum | Amande Dorette Moritz
Karl Döll | Christiane Lisette Hengelhaupt
Theodor Möller | Lina Wilhelmine Barthelmes
----------------
Friedrich August Schmidt | Emilie Wahl
Georg Kummer | Maria Barbara Müller
Emil Recknagel | Henriette Serbach
Christian Emil Fridolin Wilhelm Moeller | Auguste Hermine Lapp
Johannes Hermann Anschütz | Elise Elwine Anschütz
Gustav Karl Blum | Anna Barbara Oehrlein
Ottomar Barthelmes | Friedericke Rosalie König
----------------
Wilhelm Koehler | Friedericke Blum
Sebastian Amberg | Marie Raumschüssel
Johann Karl Friedrich Holland | Marie Amalia Wagner
Veit Oskar Oehring | Friedericke Bertha Helfricht
Karl Heinrich Franz Roeder | Emilie Pauline Jung
August Hugo Triebel | Hermine Möller
Karl Gotthilf Emil Möller | Emma Christiane Moritz
----------------
Ernst Hugo Otto | Rosalie Otto
Bernhard Friedrich Benjamin Keßner | Marie Amalia Möller
Johannes Weyrauch | Emilie Zöller
Rudolph Hirth | Wanda von Slugska
Emil Oskar Zöller | Karoline Henriette Zimmermann
Ernst Bernhard Mäurer | Lina Emilia Möller
Karl Friedrich Hasenei | Anna Christiane Wilhelmine Luck
----------------
Alwin Büchel | Maria Luise Roth
Ernst Wilhelm Hochhaus | Auguste Helfricht
Wilhelm Röhner | Friedericke Marianne Reißing